   ####   
#### #####
#### #####
#### #####
###BPB####
###PPB####
####G#####
##########
##########
##########