222222222###222222222
22222###2#G#222222222
22222#G###B#222222222
22222#B###1#####22222
22222#1111PB11G#22222
22222#B###B#####22222
22222#G###1#222222222
22222###2#1#222222222
222222222#G#222222222
222222222###222222222
222222222222222222222