####################
####################
##2222222222222222##
##2222222222222222##
##2222222222222222##
##22222B22P2222222##
##2222222222222222##
##2222222222222222##
##2222222222222222##
##22222G2222222222##
##2222222222222222##
####################