##########
##########
##########
###   ####
### P ####
###   ####
##########
##########
##########
##########