####################
####################
##1111111111111111##
##1111111111111111##
##1111111111111111##
##11111B11P1111111##
##1111111111111111##
##1111111111111111##
##1111111111111111##
##11111G1111111111##
##1111111111111111##
####################