22222222222222
22#########222
22#111111####2
2##B####1111#2
2#1P1B111B1##2
2#1GG#11B1###2
2##GG#1111##22
22##########22
22222222222222