     #1#########
     ####111####
     ####1B1####
     ####111####
     ####1PB111#
     ####111####
     ####1G1####
     ###########
     ###########
     ###########