###########
####   ####
#### B ####
#### P ####
#####G#####
# B     B #
#         #
#    G    #
 #       #
  #     #
   #   #
    ###
