2222222222222222222
22222####2222#22#22
22222#GG#2222#22#22
2222##1G##222222222
2222#11BG#222#222#2
222##1B11##222###22
222#11#BB1#22222222
222#11P111#22BBBB22
222########22BBB222
2222222222222BBB222