###########
####111####
####1B1####
####1P1####
#####G#####
#1B11111B1#
#111111111#
#1111G1111#
2#1111111#2
22#11111#22
222#111#222
2222###2222
